0,0,0,0,0,0,0,0,0,0,0,0,0,0,0,0
0,0,0,0,0,0,0,0,0,0,0,0,0,0,0,0
0,0,0,0,0,0,0,0,0,0,0,0,0,0,0,0
0,0,0,0,0,0,0,0,0,0,0,0,0,0,0,0
0,0,0,0,0,0,0,0,0,0,0,0,0,0,0,0
0,0,0,0,0,0,0,0,0,0,0,0,0,0,0,0
5,5,5,5,5,1,1,1,1,1,1,1,5,5,5,5
5,5,4,4,4,4,4,4,4,4,4,4,4,4,5,5
5,4,4,4,4,4,4,4,4,4,4,4,4,4,4,5
5,4,4,4,3,4,4,4,4,4,4,4,4,4,4,5
5,4,4,4,4,4,4,4,4,4,4,4,4,4,4,5
5,4,4,3,4,3,4,4,4,4,4,4,4,4,4,5
5,4,4,4,4,4,4,4,4,4,4,4,4,4,4,5
5,4,4,4,4,3,4,4,4,4,4,4,4,4,4,5
5,4,4,4,4,4,4,4,4,4,4,4,4,4,4,5
5,4,4,4,4,4,4,3,4,4,4,4,4,4,4,5
5,4,4,4,4,4,4,4,4,4,4,4,4,4,4,5
5,4,4,4,4,4,4,4,4,4,4,4,4,4,4,5
5,4,4,4,4,4,4,4,3,4,4,4,4,4,4,5
5,4,4,4,4,4,4,4,4,4,4,4,4,4,4,5
5,4,4,4,4,4,4,3,4,4,4,4,4,4,4,5
5,4,4,4,4,4,4,4,4,4,4,4,4,4,4,5
5,4,4,4,4,4,4,4,4,4,4,4,4,4,4,5
5,4,4,4,4,4,4,4,4,4,4,4,4,4,4,5
5,4,4,4,4,4,4,4,4,4,4,4,4,4,4,5
5,4,4,4,4,4,4,4,3,3,3,3,3,3,3,5
5,4,4,4,4,3,3,3,3,3,3,3,3,3,3,5
5,4,4,3,3,3,3,3,3,3,3,3,3,3,3,5
5,4,4,4,4,4,4,3,3,3,3,3,3,3,3,5
5,4,4,4,4,4,4,4,4,4,3,3,3,3,3,5
5,4,4,4,4,4,4,4,4,4,4,4,4,4,4,5
5,4,4,4,4,4,4,4,4,4,4,4,4,4,4,5
5,4,4,4,4,4,4,4,4,4,4,4,4,4,4,5
5,4,4,4,4,4,4,4,4,4,4,4,4,4,4,5
5,4,4,4,3,4,4,4,4,4,4,4,4,4,4,5
5,4,4,4,4,4,4,4,4,4,4,4,4,4,4,5
5,4,4,3,4,4,4,4,4,4,4,4,4,4,4,5
5,4,4,4,4,4,4,4,4,4,4,4,4,4,4,5
5,4,4,4,3,4,4,4,4,4,4,4,4,4,4,5
5,4,4,4,4,4,4,4,4,4,4,4,4,4,4,5
5,4,4,4,4,4,3,4,4,4,4,4,4,4,4,5
5,4,4,4,4,4,4,4,4,4,4,4,4,4,4,5
5,4,4,4,3,4,4,4,4,4,4,4,4,4,4,5
5,4,4,4,4,4,4,4,4,4,4,4,4,4,4,5
5,4,4,4,4,4,4,3,4,4,4,4,4,4,4,5
5,4,4,4,4,4,4,4,4,4,4,4,4,4,4,5
5,4,4,4,4,4,4,4,4,3,4,4,4,4,4,5
5,4,4,4,4,4,4,4,4,4,4,4,4,4,4,5
5,4,4,4,4,4,4,4,4,4,4,4,4,4,4,5
5,4,4,4,4,4,4,4,4,4,4,4,4,4,4,5
5,4,4,4,4,4,4,4,4,4,4,4,4,4,4,5
5,4,4,4,4,4,4,4,4,4,4,4,4,4,4,5
5,4,4,3,3,3,3,3,4,4,4,4,4,4,4,5
5,3,3,3,3,3,3,3,3,4,4,4,4,4,4,5
5,3,3,3,3,3,3,3,3,3,3,4,4,4,4,5
5,3,3,3,3,3,3,3,3,3,3,4,4,4,4,5
5,3,3,4,4,4,4,4,4,4,4,4,4,4,4,5
5,4,4,4,4,4,4,4,4,4,4,4,4,4,4,5
5,4,4,4,4,4,4,4,4,4,4,4,4,4,4,5
5,4,4,4,4,4,4,4,4,4,4,4,4,4,4,5
5,4,4,4,4,4,4,4,4,4,4,4,4,4,4,5
5,4,4,4,4,4,4,4,4,4,4,4,4,4,4,5
5,4,4,4,4,4,4,4,4,4,4,4,4,4,4,5
5,4,4,4,4,4,4,4,4,4,4,4,4,4,4,5
5,4,4,4,4,4,4,4,4,4,4,4,4,4,4,5
5,4,4,4,4,4,4,4,4,4,4,4,4,4,4,5
5,4,4,4,4,4,4,4,4,4,4,4,4,4,4,5
5,4,4,4,4,4,4,4,4,4,4,4,4,4,4,5
5,4,4,4,4,4,4,4,4,4,4,4,4,4,4,5
5,4,4,4,4,4,4,4,4,4,4,4,4,4,4,5
5,4,4,4,4,4,4,4,4,4,4,4,4,4,4,5
5,4,4,4,4,4,4,4,4,4,4,4,3,4,4,5
5,4,4,4,4,4,4,4,4,4,4,4,4,4,4,5
5,4,4,4,4,4,4,4,4,4,4,3,4,4,4,5
5,4,4,4,4,4,4,4,4,4,4,4,4,4,4,5
5,4,4,4,4,4,4,4,4,4,4,4,3,4,4,5
5,4,4,4,4,4,4,4,4,4,3,4,4,4,4,5
5,4,4,4,4,4,4,4,4,4,4,4,4,4,4,5
5,4,4,4,4,4,4,4,3,4,3,4,4,4,4,5
5,4,4,4,4,4,4,4,4,4,4,4,4,4,4,5
5,4,4,4,4,4,4,4,4,4,4,4,4,4,4,5
5,4,4,4,4,4,4,3,4,4,4,4,4,4,4,5
5,4,4,4,4,4,4,4,4,4,4,4,4,4,4,5
5,4,4,4,4,4,4,4,4,4,4,4,4,4,4,5
5,4,4,4,4,4,4,4,4,4,4,4,4,4,4,5
5,4,4,4,4,4,4,4,4,4,4,4,4,4,4,5
5,4,4,4,4,4,4,4,4,4,4,4,4,4,4,5
5,4,4,4,4,4,4,4,4,4,4,4,4,4,4,5
5,4,4,4,4,4,4,4,4,4,4,4,4,4,4,5
5,4,4,4,4,4,4,4,4,4,4,4,4,4,4,5
5,4,4,4,4,4,4,4,4,4,4,4,4,4,4,5
5,4,4,4,4,4,4,4,4,4,4,4,4,4,4,5
5,4,4,4,4,4,4,4,4,4,4,4,4,4,4,5
5,4,4,4,4,3,3,3,3,3,3,3,4,4,4,5
5,4,4,3,3,3,3,3,3,3,3,3,3,4,4,5
5,3,3,3,3,3,3,3,3,4,4,4,4,4,4,5
5,3,3,3,3,3,3,4,4,4,4,4,4,4,4,5
5,3,3,3,3,4,4,4,4,4,4,4,4,4,4,5
5,4,4,4,4,4,4,4,4,4,4,4,4,4,4,5
5,4,4,4,4,4,4,4,4,4,4,4,4,4,4,5
5,4,4,4,4,4,4,4,4,4,4,4,4,4,4,5
5,4,4,4,4,4,4,4,4,4,4,4,4,4,4,5
5,4,4,4,4,4,4,4,4,4,4,4,4,4,4,5
5,4,4,4,4,4,4,4,4,4,4,4,4,4,4,5
5,4,4,3,4,4,4,4,4,4,4,4,4,4,4,5
5,4,4,4,4,4,4,4,4,4,4,4,4,4,4,5
5,4,3,4,4,4,4,4,4,4,4,4,4,4,4,5
5,4,4,4,4,4,4,4,4,4,4,4,4,4,4,5
5,4,4,3,4,4,4,4,4,4,4,4,4,4,4,5
5,4,4,4,4,4,4,4,4,4,4,4,4,4,4,5
5,4,3,4,4,4,4,4,4,4,4,4,4,4,4,5
5,4,4,4,4,4,4,4,4,4,4,4,4,4,4,5
5,4,4,3,4,4,4,4,4,4,4,4,4,4,4,5
5,4,4,4,4,4,4,4,4,4,4,4,4,4,4,5
5,4,3,4,4,4,4,4,4,4,4,4,4,4,4,5
5,4,4,4,4,4,4,4,4,4,4,4,4,4,4,5
5,4,4,4,4,4,4,4,4,4,4,4,4,4,4,5
5,4,4,4,4,4,4,4,4,4,4,4,4,4,4,5
5,4,4,4,4,4,4,4,4,4,4,4,4,4,4,5
5,4,4,4,4,4,4,4,4,4,4,4,4,4,4,5
5,4,4,4,4,4,4,4,4,4,4,4,4,4,4,5
5,4,4,4,4,4,4,4,4,4,4,4,4,4,4,5
5,4,4,4,4,4,4,4,4,4,4,4,4,4,4,5
5,4,4,4,4,4,4,4,4,4,4,4,4,4,4,5
5,4,4,4,4,4,4,4,4,4,4,4,4,4,4,5
5,4,4,4,4,4,4,4,4,4,4,4,4,4,4,5
5,4,4,4,4,4,4,4,4,4,4,4,4,4,4,5
5,4,4,4,4,4,4,4,4,4,4,4,4,4,4,5
5,4,4,4,4,3,3,3,3,3,3,3,3,4,4,5
5,4,4,4,3,3,3,3,3,3,3,3,3,3,3,5
5,4,4,4,3,3,3,3,3,3,3,3,3,3,3,5
5,4,4,4,4,4,3,3,3,3,3,3,3,3,3,5
5,4,4,4,4,4,4,4,4,3,3,3,3,3,3,5
5,3,3,4,4,4,4,4,4,4,4,4,4,4,4,5
5,3,3,3,3,4,4,4,4,4,4,4,4,4,4,5
5,3,3,3,3,3,3,4,4,4,4,4,4,4,4,5
5,3,3,3,3,3,3,4,4,4,4,4,4,4,4,5
5,3,3,3,3,3,3,3,3,3,4,4,4,4,4,5
5,3,3,3,3,3,3,3,3,3,3,3,3,3,3,5
5,3,3,3,3,3,3,3,3,3,3,3,3,3,3,5
5,3,3,3,3,3,3,3,3,3,3,3,3,3,3,5
5,3,3,3,3,3,3,3,3,3,3,3,3,3,3,5
5,3,3,3,3,3,3,3,3,3,3,3,3,3,3,5
5,3,3,3,3,3,3,3,3,3,3,3,3,3,3,5
5,3,3,3,3,3,3,3,3,3,3,3,3,3,3,5
5,3,3,3,3,3,3,3,3,3,3,3,3,3,3,5
5,3,3,3,3,3,3,3,3,3,3,3,3,3,3,5
5,3,3,3,3,3,3,3,3,3,3,3,3,3,3,5
5,3,3,3,3,3,3,3,3,3,3,3,3,3,3,5
5,3,3,3,3,3,3,3,3,3,3,3,3,3,3,5
5,3,3,3,3,3,3,3,3,3,3,3,3,3,3,5
5,3,3,3,3,3,3,3,3,3,3,3,3,3,3,5
5,3,3,3,3,3,3,3,3,3,3,3,4,3,3,5
5,3,3,3,3,3,3,3,3,3,3,3,3,3,3,5
5,3,3,3,3,3,3,3,3,3,3,4,3,3,3,5
5,3,3,3,3,3,3,3,3,3,3,3,3,3,3,5
5,3,3,3,3,3,3,3,3,3,3,3,4,3,3,5
5,3,3,3,3,3,3,3,3,3,3,3,3,3,3,5
5,3,3,3,3,3,3,3,3,3,3,4,3,3,3,5
5,3,3,3,3,3,3,3,4,3,3,3,3,3,3,5
5,3,3,3,3,3,3,3,3,3,3,3,3,3,3,5
5,3,3,3,3,3,3,3,3,3,3,3,3,3,3,5
5,3,3,3,3,3,3,3,3,4,3,3,3,3,3,5
5,3,3,3,3,3,3,3,3,3,3,3,3,3,3,5
5,3,3,3,3,3,3,3,3,3,3,3,3,3,3,5
5,3,3,3,3,3,3,3,3,3,4,3,3,3,3,5
5,3,3,3,3,3,3,3,3,3,3,3,3,3,3,5
5,3,3,3,3,3,3,3,4,3,3,3,3,3,3,5
5,3,3,3,3,3,3,3,3,3,3,3,3,3,3,5
5,3,3,3,3,3,3,3,3,3,3,3,3,3,3,5
5,3,3,3,3,3,3,3,3,3,3,3,3,3,3,5
5,3,3,3,3,3,3,3,3,3,3,3,3,3,3,5
5,4,4,4,4,4,4,4,3,3,3,3,3,3,3,5
5,4,4,4,4,4,4,4,4,4,4,3,3,3,3,5
5,4,4,4,4,4,4,4,4,4,4,3,3,3,3,5
5,3,4,4,4,4,4,4,4,4,3,3,3,3,3,5
5,3,3,4,4,3,4,4,4,4,3,3,3,3,3,5
5,3,3,3,3,3,3,3,3,3,3,3,3,3,3,5
5,3,3,3,3,3,3,3,3,3,3,3,3,3,3,5
5,3,3,3,3,3,3,3,3,3,3,3,3,3,3,5
5,3,3,3,3,3,3,3,3,3,3,3,3,3,3,5
5,3,3,3,3,3,3,3,3,3,3,3,3,3,3,5
5,3,3,3,3,3,3,3,3,3,3,3,3,3,3,5
5,3,3,3,3,3,3,3,3,3,3,3,3,3,3,5
5,3,3,3,3,3,3,3,3,3,3,3,3,3,3,5
5,3,3,3,3,3,3,3,3,3,3,3,3,3,3,5
5,3,3,3,3,3,3,3,3,3,3,3,3,3,3,5
5,3,3,3,3,3,3,3,3,3,3,3,3,3,3,5
5,3,3,4,3,3,3,3,3,3,3,3,3,3,3,5
5,3,3,3,3,3,3,3,3,3,3,3,3,3,3,5
5,3,4,3,3,3,3,3,3,3,3,3,3,3,3,5
5,3,3,3,3,3,3,3,3,3,3,3,3,3,3,5
5,3,3,3,3,3,3,3,3,3,3,3,3,3,3,5
5,3,3,4,3,3,3,3,3,3,3,3,3,3,3,5
5,3,3,3,3,3,3,3,3,3,3,3,3,3,3,5
5,3,4,3,3,3,3,3,3,3,3,3,3,3,3,5
5,3,3,3,3,3,3,3,3,3,3,3,3,3,3,5
5,3,3,4,3,3,3,3,3,3,3,3,3,3,3,5
5,3,3,3,3,3,3,3,3,3,3,3,3,3,3,5
5,3,4,3,3,3,3,3,3,3,3,3,3,3,3,5
5,3,3,3,3,3,3,3,3,3,3,3,3,3,3,5
5,3,3,3,3,3,3,3,3,3,4,4,4,4,3,5
5,3,3,3,3,3,4,4,4,4,4,4,4,4,4,5
5,3,3,3,3,3,4,4,4,4,4,4,4,4,4,5
5,3,3,4,4,4,4,4,4,4,4,4,4,4,4,5
5,3,3,4,4,4,4,4,4,4,4,4,4,4,3,5
5,3,3,3,3,3,3,3,3,3,3,3,3,3,3,5
5,3,3,3,3,3,3,3,3,3,3,3,3,3,3,5
5,3,3,3,3,3,3,3,3,3,3,3,3,3,3,5
5,3,3,3,3,3,3,3,3,3,3,3,3,3,3,5
5,3,3,3,3,3,3,3,3,3,3,3,3,3,3,5
5,3,3,3,3,3,3,3,3,3,3,3,3,3,3,5
5,3,3,3,3,3,3,3,3,3,3,3,3,3,3,5
5,3,3,3,3,3,3,3,3,3,3,3,3,3,3,5
5,3,3,3,3,3,3,3,3,3,3,3,3,3,3,5
5,3,3,3,3,3,3,3,3,3,3,3,3,3,3,5
5,3,3,3,3,3,3,3,3,3,3,3,3,3,3,5
5,3,3,3,3,3,3,3,3,3,3,3,3,3,3,5
5,3,3,3,3,3,3,3,3,3,3,3,3,3,3,5
5,3,3,3,3,3,3,3,3,3,3,3,3,3,3,5
5,3,3,3,3,3,3,3,3,3,3,3,3,3,3,5
5,3,3,3,3,3,3,3,3,3,3,3,3,3,3,5
5,4,4,4,4,4,4,4,4,4,4,4,4,4,3,5
5,4,4,4,4,4,4,4,4,4,4,4,4,3,3,5
5,4,4,4,4,4,4,4,4,4,4,3,3,3,3,5
5,4,4,4,4,4,4,3,3,3,3,3,3,3,3,5
5,3,4,4,4,4,3,3,3,3,3,3,3,3,3,5
5,3,3,3,3,3,3,3,3,3,3,3,3,3,3,5
5,3,3,3,3,3,3,3,3,3,3,3,3,3,3,5
5,3,3,3,3,3,3,3,3,3,3,3,3,3,3,5
5,3,3,3,3,3,3,3,3,3,3,3,3,3,3,5
5,3,3,3,3,3,3,3,3,3,3,3,3,3,3,5
5,3,3,3,3,3,3,3,3,3,4,3,3,3,3,5
5,3,3,3,3,3,3,3,3,3,3,3,3,3,3,5
5,3,3,3,3,3,3,3,3,3,3,4,3,3,3,5
5,3,3,3,3,3,3,3,4,3,3,3,3,3,3,5
5,3,3,3,3,3,3,3,3,3,3,3,3,3,3,5
5,3,3,3,3,3,3,3,3,4,3,3,3,3,3,5
5,3,3,3,3,3,3,3,3,3,3,4,3,3,3,5
5,3,3,3,3,3,3,3,3,3,3,3,3,3,3,5
5,3,3,3,3,3,3,3,4,3,3,3,3,3,3,5
5,3,3,3,3,3,3,3,3,3,3,3,3,3,3,5
5,3,3,3,3,3,3,3,3,3,3,3,3,3,3,5
5,3,3,3,3,3,3,3,4,3,3,3,3,3,3,5
5,3,3,3,3,3,4,3,3,3,3,3,3,3,3,5
5,3,3,3,3,3,3,3,3,3,3,3,3,3,3,5
5,3,3,3,3,3,3,3,3,3,3,3,3,3,3,5
5,3,3,3,3,3,3,3,3,3,3,3,3,3,3,5
5,3,3,3,3,3,3,3,3,3,3,3,3,3,3,5
5,3,3,3,3,3,3,3,3,3,3,3,3,3,3,5
5,3,3,3,3,3,3,3,3,3,3,3,3,3,3,5
5,5,3,3,3,3,3,3,3,3,3,3,3,3,5,5
5,5,5,3,3,3,3,3,3,3,3,3,3,5,5,5
5,5,5,5,3,3,3,3,3,3,3,3,5,5,5,5
5,5,5,5,5,5,5,5,5,5,5,5,5,5,5,5
5,5,5,5,5,5,5,5,5,5,5,5,5,5,5,5
